 Ministry of Education China	Beijing Institute of Technology
Ministry of Science and Technology China	Tencent
Sinopec
China Telecom Corp. Ltd.
RIKEN 	Bryant University
Weichai Power Co. Ltd.
SAIC Motor  
China Merchants Bank
Chinese Academy of Sciences
Jamia Millia Islamia	Washington University (WUSTL)
Jinan University	Chinese Academy of Engineering Physics
China People's Police University
Beihang University	North China Electric Power University
Cornell University
Delft University of Technology	University of Science & Technology Beijing
Guangxi University
Tsinghua University	University of Gottingen
Xiamen University
Chang'an University	Swinburne University of Technology
Northwestern Polytechnical University	China Agricultural University
Royal Institute of Technology
King Khalid University	Nankai University
Southern University of Science & Technology
Peking University
Shanghai Institute of Technology	Yancheng Institute of Technology
Lanzhou University	Northwestern University
University of Hong Kong
Shandong Normal University	Nanjing University of Science & Technology
University of Chicago
Bohai University	University of Shanghai for Science & Technology
Henan Polytechnic University	Communication University of Zhejiang
University of Delaware	Zaozhuang University
Shandong University of Science & Technology	China National Nuclear Corporation  
Lanzhou City University	North China Institute Science & Technology 
Clemson University	Beijing Technology & Business University
Korea University	Hong Kong Polytechnic University
Ming Chuan University	Beijing Institute of Fashion Technology
University of Oxford	Nanjing University of Finance & Economics
Xi'an Jiaotong University	Dalian Polytechnic University
Academy of Military Medical Sciences - China	University of New South Wales Sydney
Liaoning University of Technology	University of Alberta
Hebei University	Kyushu University
Shenyang Aerospace University	University of Sydney
Dalian University of Technology
Xi'an University of Science & Technology
Taiyuan University of Technology	China Electronics Technology Group 
Shanghai University	Alibaba Group
Minjiang University
PLA Information Engineering University
Air Force Military Medical University
Tiangong University
University of the South Pacific	Beijing University of Posts & Telecommunications
Wageningen University & Research	University of Gujrat  
Cranfield University	Beijing University of Chinese Medicine
Chengdu University of Traditional Chinese Medicine
Hebei Normal University	Guangxi Normal University
Ningbo University	North University of China
Capital University of Science & Technology	Inner Mongolia Agricultural University
Hebei University of Technology
National University of Singapore	Capital Normal University
Harbin Institute of Technology
Jiangsu University	University of Waterloo
Beijing University of Chemical Technology	Zhejiang Ocean University
Massachusetts Institute of Technology (MIT)	Renmin University of China
Yanan University	Fujian University of Technology
Tianjin University	City University of Hong Kong
University of Glasgow 	Hefei University of Technology
Yuncheng University	Hazara University
Northeastern University - China	Foshan University
Sichuan Normal University	University of Sharjah
National University of Defense Technology - China
Max Planck Society
Yanshan University
Beijing Information Science & Technology University	University of Virginia
Shanghai Jiao Tong University	Aerospace Engineering University
Ministry of Public Security (China)
Kagawa University	Zhengzhou University
Chuxiong Normal University	Inha University
Zhejiang University	Villanova University  
Chengdu University of Information Technology
Beijing University of Technology
Shenzhen University	China University of Petroleum  
Xi'an Modern Chemistry Research Institute	Universitat Siegen  
Beijing Jiaotong University	Huazhong University of Science & Technology
China State Construction Engineering Corporation
Chiang Mai University	Yantai University 
Cheng Shiu University	Hong Kong University of Science & Technology
Case Western Reserve University	Hong Kong Baptist University
Anhui University of Finance & Economics	Army Engineering University of PLA  
Shandong University	Jiujiang University
Xuzhou University of Technology	Harbin University of Science & Technology
Aalto University	Hangzhou Hikvision Digital Technology Co. Ltd.
Sichuan University	Beijing Union University
Liaoning University	Hunan University 
Jinzhong University	Harbin Normal University 
University of Technology Sydney	Nanning Normal University
Australian National University
China Academy of Safety Science & Technology	China University of Mining & Technology
University of the Sunshine Coast	University of Kiel
University of Bonn	Chongqing University of Technology
Yale University	Nanjing University of Posts & Telecommunications
Imperial College London	University of Canterbury
Peng Cheng Laboratory	Central South University
Tongji University	Ibaraki University
University of International Business & Economics	University of Bath
Beijing Institute of Aeronautical Material	Wuhan University of Technology
Sun Yat Sen University	Zhengzhou University of Light Industry
Capital Medical University	Scuola Superiore Sant'Anna
Jianghan University	University of Auckland
University of Yaounde I	University of Electronic Science & Technology of China  
Beijing University of Civil Engineering & Architecture
Shanxi Agricultural University	Universidade Federal de Santa Catarina (UFSC) 
Universidad Nacional Autonoma de Mexico	Technical University of Munich
Qinghai University	Duke University
Technische Universitat Dresden   University of Zurich
University of Sherbrooke	Jining University 
University of Aizu	University of Windsor