 Here is the list of nations for the given universities and institutes:

Luxembourg Institute of Science & Technology	Luxembourg 
Agriculture & Agri Food Canada	Canada
Instituto de Investigaciones Biologicas Clemente Estable Uruguay	Uruguay
Mackay Medical College	Australia
Ajinomoto Co Inc	Japan
University of Lubeck	Germany
Institut National Polytechnique de Toulouse	France
National Institute of Genetics (NIG) - Japan	Japan
Research Institute for Neurosciences & Medicine	Switzerland
Spaulding Rehabilitation Hospital	United States
DePaul University	United States
Johann Heinrich von Thunen Institute	Germany 
University of Ibadan	Nigeria
Roehampton University	United Kingdom
Universidad Costa Rica	Costa Rica
Kansas State University	United States
University of Fort Hare	South Africa
Rhodes University	South Africa
Mansoura University	Egypt
Teikyo University	Japan
US Food & Drug Administration (FDA)	United States
Royal Infirmary of Edinburgh	United Kingdom
NIH National Institute of Neurological Disorders & Stroke (NINDS)	United States
Medical University of Vienna	Austria
Konkuk University	South Korea
Toronto General Hospital	Canada
Helmholtz-Zentrum Geesthacht - Zentrum fur Material- und Kustenforschung	Germany
Jan Kochanowski University	Poland
Universite de M'sila  	Algeria
China Railway Construction Corporation	China
Ministry of Justice - Egypt	Egypt 
Komsomolsk-na-Amure State University	Russia
Wright State University Dayton	United States
Oles Honchar Dnipro National University	Ukraine
NITEC University   	India
SUNY Fredonia	United States
Polytechnic University of Bucharest	Romania
Shandong Management University	China
Universidad de Cuenca	Ecuador
Bashkir State Agrarian University	Russia
Defence Science & Technology	Australia
Institute of Technical Chemistry of the Ural Branch RAS	Russia
Kostroma State University 	Russia
Moscow State University of Food Production	Russia
University of Zagreb	Croatia
CSIC - Institut de Robotica i Informatica Industrial (IRII)	Spain
Kennesaw State University	United States
Le Mans Universite  	France
Nuclear Materials Authority (NMA)  	Egypt
Linnaeus University 	Sweden
Pacific Geographical Institute of the Far Eastern Branch of the Russian Academy of Sciences	Russia
Pukyong National University	South Korea
Diponegoro University	Indonesia
University of Craiova  	Romania
Kurdyumov Institute of Metal Physics	Ukraine
Institute of Mathematics of the Romanian Academy	Romania
CIC Energigune	Spain
Pennsylvania Medicine	United States 
Gakushuin University	Japan
Chinese Academy of Surveying & Mapping	China
Guangzhou Marine Geological Survey	China
Brandon University	Canada
GH Asachi Technical University	Romania 
Northern Arctic Federal University  	Russia
Cherkas Global University	Ukraine
Universite de Tunis-El-Manar	Tunisia
Zhaotong University 	China
Rikkyo University	Japan
Qingdao Institute of Marine Geology (QIMG)	China
Ajman University	United Arab Emirates
Tokyo Medical & Dental University (TMDU)	Japan
Russian State Vocational Pedagogical University	Russia
Criminal Investigation Police University of China	China
China Iron & Steel Research Institute Group	China
Democritus University of Thrace	Greece
Abdus Salam International Centre for Theoretical Physics (ICTP)	Italy
Guilin Medical University	China
National Agriculture & Food Research Organization - Japan  	Japan 
ABB	Switzerland
Suzhou University	China
Irkutsk State University	Russia
National University of Mongolia	Mongolia
ESSEC Business School	France
WSB University	Poland
Zhongguancun Laboratory	China
Feed Research Institute CAAS  	China
National Institute of Aeronautics & Space of Indonesia (LAPAN)	Indonesia
Qihoo 360 Technology	China
XLRI -Xavier School of Management	India
Claremont Graduate School	United States
Birkbeck University London	United Kingdom
University of London School Oriental & African Studies (SOAS)	United Kingdom
National Center for Chronic & Noncommunicable Disease Control & Prevention Chinese Center for Disease Control & Prevention  	China
Institute of BioMedical Engineering - CAMS	China
Kaunas University of Technology	Lithuania
National Marine Environmental Monitoring Center	China  
Universidad Nacional de Colombia 	Colombia
Bashkir State Medical University	Russia
Institut d'Etudes Politiques Paris (Sciences Po)	France
Samara Scientific Center of the Russian Academy of Sciences	Russia
University of Oklahoma Health Sciences Center	United States
Grenoble Ecole Management	France
Guangzhou Institute of Geography Guangdong Academy of Sciences	China
Shougang Group	China
Nanjing Normal University of Special Education	China
GlobalFoundries	United States
CSIC-UIB - Instituto de Fisica Interdisciplinar y Sistemas Complejos (IFISC)	Spain
National Astronomical Observatory of Japan (NAOJ)	Japan
Beijing Advanced Sciences & Innovation Center CAS	China
American University of Sharjah	United Arab Emirates 
Gansu University of Political Science & Law	China
Swiss Federal Institute of Aquatic Science & Technology (EAWAG)	Switzerland
National University of Political Studies & Public Administration  	Romania
Changchun University of Chinese Medicine	China
Resources for the Future	United States
Xiamen Tungsten Co Ltd  	China
Beijing Institute of Genomics CAS	China
NASA Goddard Space Flight Center	United States
California State University Fullerton	United States
Infrastructure University Kuala Lumpur (IUKL)	Malaysia
Norwegian University of Life Sciences	Norway 
Leibniz Institut fur Plasmaforschung und Technologie	Germany
South Eastern University of Sri Lanka	Sri Lanka
A*STAR - Singapore Bioimaging Consortium (SBIC)	Singapore
A*STAR - Institute of Bioengineering & Bioimaging (IBB)	Singapore
Natural Environment Research Council (NERC)	United Kingdom
Plymouth Marine Laboratory 	United Kingdom  
NERC National Centre for Earth Observation	United Kingdom
University for Development Studies	Ghana
Innovative Scientific Solutions Inc.	United States
Plastic Surgery Hospital - CAMS	China
Yokohama City University	Japan
Institute of Eco-environmental & Soil Sciences Guangdong Academy of Sciences	China
David Geffen School of Medicine at UCLA	United States
University of California Los Angeles Medical Center	United States
October 6 University (O6U)	Egypt
Ain Shams University	Egypt
Telkom University	Indonesia
Universidade Federal do Espirito Santo	Brazil
Lishui University	China
University of Montenegro 	Montenegro
Leibniz Institut fur Tropospharenforschung (TROPOS)	Germany  
University of Tehran	Iran
Toyota Motor Corporation	Japan
Ecole Nationale dIngenieurs de Sfax (ENIS)	Tunisia
University of Central Arkansas	United States
Taibah University	Saudi Arabia
Universidade Federal do Parana	Brazil
Nosov Magnitogorsk State Technical University	Russia
Guangxi University of Finance & Economics	China
Rollins School Public Health	United States
Okayama Prefectural University	Japan
NICTA	Australia
West University of Timisoara	Romania
Lublin University of Technology	Poland
Zhongkai University of Agriculture & Engineering	China
Intelligent Fusion Technology	China
Binzhou Polytechnic	China
University of Zielona Gora	Poland
National Center Atmospheric Research (NCAR) - USA	United States
Meharry Medical College	United States
Tohoku Gakuin University	Japan
Technical University of Crete	Greece
Universidad ICESI	Colombia
Universidad de la Laguna	Spain
Instituto de Astrofisica de Canarias	Spain
New Mexico Institute of Mining Technology  	United States
Samsung Display	South Korea
Vidyasirimedhi Institute of Science & Technology	Thailand
Electricite de France (EDF)	France
Kermanshah University of Technology	Iran
Korea Aerospace University	South Korea
CSIC - Instituto de Fisica Fundamental (IFF)	Spain
BMW AG	Germany
Ecole nationale superieure de chimie de Montpellier 	France
Ecole Superieure de Physique et de Chimie Industrielles de la Ville de Paris (ESPCI)	France
Jiangsu Academy of Agricultural Sciences	China
Department of Space (